6 6 6 6 6 6 6 6 6 6 6 6 6 6 6 6 6 6 6 6 6
6 6 6 6 6 6 6 6 6 6 6 6 6 6 6 6 6 6 6 6 6  
6 5 5 5 5 5 5 5 5 5 5 5 5 5 5 5 5 5 5 5 6  
6 1 1 4 1 1 1 4 1 1 1 4 1 1 1 1 -1 1 1 1 6  
6 1 1 1 1 1 1 1 1 1 1 1 1 1 1 1 1 1 1 1 6  
6 1 1 1 1 1 1 4 1 1 1 1 -1 1 1 -1 1 1 1 1 6  
6 1 1 1 4 1 1 -1 1 4 1 1 4 1 1 1 1 4 1 1 6  
6 1 1 1 1 -1 1 1 1 1 1 1 -1 1 1 1 1 1 1 1 6  
6 1 -1 1 1 1 1 4 1 1 1 1 1 1 1 4 1 1 1 4 6  
6 1 1 1 1 4 1 1 1 1 4 1 1 1 1 1 1 -1 1 1 6  
6 1 1 4 1 1 1 4 1 1 1 1 -1 1 1 -1 1 1 1 1 6  
6 6 6 6 6 6 6 6 6 6 6 6 6 6 6 6 6 6 6 6 6  